PXXXXXXXXXXXXXXXXXXXXXXXXXXXXXXXXXXXXXXXXXXXXXXXXX
X                                                X
X                                                X
X                                                X
X                                                X
X      C                                         X
X                                                X
X                                                X
X                                                X
X                                                X
X                                                X
X                                                X
X                                                X
X                                                X
X                                                X
X                                                X
X                                                X
X                                                X
X                                                X
X                                                X
X                                    E           X
X                                                X
X                                                X
X                                                X
X                                                X
X                                                X
X                                                X
X                                                X
X                                                X
X                                                X
X                                                X
X                                                X
X                                                X
X                                                X
X                                                X
X                                                X
X                                                X
X                                                X
X                                                X
X                                                X
X                                                X
X                                                X
X                                                X
X                                                X
X                                                X
X                                                X
X                                                X
X                                                X
X                                                X
XXXXXXXXXXXXXXXXXXXXXXXXXXXXXXXXXXXXXXXXXXXXXXXXXX
